{
  "num_levels": 2,
  "levels": [
    {
      "width": 30,
      "height": 15,
      "tiles": [
        "##############################",
        "##############################",
        "##############################",
        "#####....................#####",
        "#####....................#####",
        "#####....................#####",
        "#####....................#####",
        "#####.....>....$....<....#####",
        "#####....................#####",
        "#####....................#####",
        "#####....................#####",
        "#####....................#####",
        "##############################",
        "##############################",
        "##############################"
      ],
      "stairs_up": [
        10,
        7
      ],
      "stairs_down": [
        20,
        7
      ],
      "chests": [
        [
          15,
          7
        ]
      ],
      "monsters": [
        {
          "name": "Goblin Guard",
          "hit_dice": "2d8",
          "armor_class": 14,
          "attack_bonus": 2,
          "damage": "1d6+1",
          "position": [8, 7]
        },
        {
          "name": "Orc Warrior",
          "hit_dice": "3d8+3",
          "armor_class": 15,
          "attack_bonus": 3,
          "damage": "1d8+2",
          "position": [22, 7]
        }
      ]
    },
    {
      "width": 30,
      "height": 15,
      "tiles": [
        "##############################",
        "##############################",
        "##############################",
        "##############################",
        "##############################",
        "###.......##########.......###",
        "###.......##########.......###",
        "###...>.................<..###",
        "###...$...##########....$..###",
        "###.......##########.......###",
        "##############################",
        "##############################",
        "##############################",
        "##############################",
        "##############################"
      ],
      "stairs_up": [
        6,
        7
      ],
      "stairs_down": [
        24,
        7
      ],
      "chests": [
        [
          6,
          8
        ],
        [
          24,
          8
        ]
      ],
      "monsters": []
    }
  ]
}