{
  "num_levels": 2,
  "levels": [
    {
      "width": 40,
      "height": 15,
      "tiles": [
        "########################################",
        "#......................................#",
        "#......................................#",
        "#......................................#",
        "#......................................#",
        "#..........>...........$...........<...#",
        "#......................................#",
        "#......................................#",
        "#......................................#",
        "#......................................#",
        "#......................................#",
        "#......................................#",
        "#......................................#",
        "#......................................#",
        "########################################"
      ],
      "stairs_up": [11, 5],
      "stairs_down": [35, 5],
      "chests": [[23, 5]],
      "monsters": [
        {
          "name": "Boss Goblin",
          "hit_dice": "4d8+4",
          "armor_class": 16,
          "attack_bonus": 4,
          "damage": "2d6+2",
          "position": [20, 7]
        },
        {
          "name": "Goblin Minion",
          "hit_dice": "1d8",
          "armor_class": 12,
          "attack_bonus": 1,
          "damage": "1d6",
          "position": [18, 7]
        },
        {
          "name": "Goblin Minion",
          "hit_dice": "1d8",
          "armor_class": 12,
          "attack_bonus": 1,
          "damage": "1d6",
          "position": [22, 7]
        },
        {
          "name": "Skeleton Guard",
          "hit_dice": "2d8",
          "armor_class": 13,
          "attack_bonus": 2,
          "damage": "1d6+1",
          "position": [5, 3]
        },
        {
          "name": "Skeleton Guard",
          "hit_dice": "2d8",
          "armor_class": 13,
          "attack_bonus": 2,
          "damage": "1d6+1",
          "position": [5, 11]
        }
      ]
    },
    {
      "width": 40,
      "height": 15,
      "tiles": [
        "########################################",
        "#......................................#",
        "#......................................#",
        "#......................................#",
        "#......................................#",
        "#..........>...........$...........<...#",
        "#......................................#",
        "#......................................#",
        "#......................................#",
        "#......................................#",
        "#......................................#",
        "#......................................#",
        "#......................................#",
        "#......................................#",
        "########################################"
      ],
      "stairs_up": [11, 5],
      "stairs_down": [35, 5],
      "chests": [[23, 5]],
      "monsters": []
    }
  ]
}
