{
  "num_levels": 3,
  "levels": [
    {
      "width": 50,
      "height": 20,
      "tiles": [
        "##################################################",
        "##################################################",
        "####################..........####################",
        "####################.....>....####################",
        "####################..........####################",
        "####################..........####################",
        "####################..........####################",
        "#######################....#######################",
        "#####........................................#####",
        "#####........................................#####",
        "#####.....$.............................$....#####",
        "#####........................................#####",
        "#######################....#######################",
        "###############....................###############",
        "###############....................###############",
        "###############.....$..............###############",
        "###############..........<.........###############",
        "###############....................###############",
        "##################################################",
        "##################################################"
      ],
      "stairs_up": [
        25,
        3
      ],
      "stairs_down": [
        25,
        16
      ],
      "chests": [
        [
          10,
          10
        ],
        [
          40,
          10
        ],
        [
          20,
          15
        ]
      ]
    },
    {
      "width": 50,
      "height": 20,
      "tiles": [
        "##################################################",
        "##################################################",
        "############........##########........############",
        "############....$...##########....$...############",
        "############........##########........############",
        "##########..............................##########",
        "##########..............................##########",
        "##########...............>..............##########",
        "##########..............................##########",
        "##########..............................##########",
        "##########..............................##########",
        "##########..............................##########",
        "##########...............<..............##########",
        "##########..............................##########",
        "##########..............................##########",
        "############........##########........############",
        "############....$...##########....$...############",
        "############........##########........############",
        "##################################################",
        "##################################################"
      ],
      "stairs_up": [
        25,
        7
      ],
      "stairs_down": [
        25,
        12
      ],
      "chests": [
        [
          16,
          3
        ],
        [
          34,
          3
        ],
        [
          16,
          16
        ],
        [
          34,
          16
        ]
      ]
    },
    {
      "width": 50,
      "height": 20,
      "tiles": [
        "##################################################",
        "##################################################",
        "#####........................................#####",
        "#####.....>..................................#####",
        "#####..$.......#.........#.........#......$..#####",
        "#####..........#.........#.........#.........#####",
        "#####..################..#..###############..#####",
        "#####..........#.........#.........#.........#####",
        "#####........................................#####",
        "#####........................................#####",
        "#####...............$........................#####",
        "#####..........#.........#.........#.........#####",
        "#####..........#.........#.........#.........#####",
        "#####..######..#..#########################..#####",
        "#####..........#.........#.........#.........#####",
        "#####..$.......#.........#.........#.........#####",
        "#####...................................<....#####",
        "#####........................................#####",
        "##################################################",
        "##################################################"
      ],
      "stairs_up": [
        10,
        3
      ],
      "stairs_down": [
        40,
        16
      ],
      "chests": [
        [
          7,
          4
        ],
        [
          42,
          4
        ],
        [
          7,
          15
        ],
        [
          20,
          10
        ]
      ]
    }
  ]
}